1111111111111111111111111111111111111
1P0000C0110000CC001000011100000C00101
10001000011000100000000000000C0000101
1010000C0011110001E010000000C00100001
1000000100000001010111000101000000C01
100000100110000000C0000C0001100000001
1C000000000110000010000C0000C10111111
1000C0000000000CC00111000000010000001
100000000C000C00001000000101010001111
1111111111111111111111111111111111111