1111111111111
1000000000101


1P0000C0001E1
1000000000101
1000000000001
1111111111111